NO ./textures/north2.xpm
SO ./textures/south2.xpm
WE ./textures/west2.xpm
EA ./textures/east.xpm

F 150,150,150
C 100,100,255

1111111
1000001
1011101
100N001
1111111
