NO ./textures/north.xpm
SO ./textures/south.xpm
WE ./textures/west.xpm
EA ./textures/east.xpm

F 200,200,200
C 50,50,150

111111111
100000001
100110001
10S000001
111111111
