NO ./textures/north.xpm
SO ./textures/south.xpm
WE ./textures/west.xpm
EA ./textures/east.xpm

F 180,180,50
C 100,200,250

1111111
1     1
1 111 1
1 1W1 1
1 111 1
1     1
1111111
