NO ./textures/north.xpm
SO ./textures/south.xpm
WE ./textures/west.xpm
EA ./textures/east.xpm

F 150,0,0
C 0,0,150

111111111
1  1    1
1  1N1  1
1     1 1
111 111 1
1       1
111111111
