NO ./textures/north.xpm
SO ./textures/south.xpm
WE ./textures/west.xpm
EA ./textures/east.xpm

F 220,220,0
C 50,50,50

11111
1N0S1
10001
10001
11111
