NO ./textures/north.xpm
SO ./textures/south.xpm
WE ./textures/west.xpm
EA ./textures/east.xpm

F 220,220,220
C 0,0,0

11111
1N0A1
10001
10001
11111
