NO ./textures/north.xpm
SO ./textures/south.xpm
WE ./textures/west.xpm
EA ./textures/east.xpm

F 200,200,200
C 100,100,100




11111
1N001
101S1
10001
11111
